1111111111
1001000011
1000000001
1000000001
1001000001
1000000001
1000000001
1000000001
1000000001
1111111111
{5,0,2,5},{2,2,8,8},{4,2,2,7},{3,2,7,7},{6,0,2,0}